1111111
1P00C01
10000E1
11111111