111111
1P0101
100C11
100011
1000E1
111111