1111111
1P00C01
1000001
1111111