11111111111111111111111111111111
1000C0000000C0000C00000000010001
1P00CCC000000000C000000000100001
1000000000000000C000000000100001
10000000000000000000000001000001
1000C000001100000000000000001001
10000000000000000000000001000001
1000C000000000000000000001000001
1000000000000000C000000000100001
1000C0000000C00000E0000001000001
10000000000000000000000001000001
1000C000000000000000000001000101
1000C00000000000C000000000100001
11111111111111111111111111111111