MMMMMMMMMMMMMMMMMMMMMMMMMMMMMMMMMMMMMMMMMMMM
M000000000000000000000000000000000000000000M
M000000000000000000000000000000000000000000M
M000000000000000000000000000000000000000000M
M000000000000000P00000000000000000000000000M
MMMMMMMMMMMMMMMMMMMMMMMMMMMMMMMMMMMMMMMMMMMM
