111111111111
1P00C0000001
100000000001
100000000E01
111111111111