MMMMMMMMMMMMMMMMMMMMMMMMMMM
M0000000000000000000000000M
M0P00000000000000000000000M
M0000000000000000000000000M
M0000000000000C00000000000M
M0000000000000000000000000M
M0000000000000000000000000M
M0000000000000000000000000M
M000000000000000000000E000M
MMMMMMMMMMMMMMMMMMMMMMMMMMM