MMMMMMMMMMMMMMMMMMMMMMMMMMMMMMMMMMMMMMMMMMMM
M000000000000000000000000000000000000000000M
M000000000000000000000000000000000000000000M
M0000000000000P0000000000000000000000000000M
M000000000000000000000000000000000000000000M
MMMMMMMMMMMMMMMMMMMMMMMMMMMMMMMMMMMMMMMMMMMM
