111111111111111111111
1P0000000000000000001
10000000000C0000000001
1000000000000000000E01
111111111111111111111