111111111111111111111111111111111111111
100P00000000000C00000000000000000000001
101010101010101010101010101010101010001
101010101010101010101010101010101010001
100000C0000000000000C000000000000000001
101010100010101010101010101010101010001
100000000000000000000000000000000000001
101010101000000000000000000000001010001
101000001111000000000000000000000000001
1000000000000000000000000000C0000000001
100000C00000000011111110000000000000001
100001010000000000000000000000000000001
101010101000000C00000000000000000000001
1000000000000000000000000000E0000000001
101010101010101010101010101010101010001
111111111111111111111111111111111111111

