MMMMMMMMMMMMMMMMMMMM11111111111111
1202020202020202020202020202020201
1020202020202020202020202020202021
1202020202020202020202020202020201
1020202020202020202020202020202021
1202020202020202020202020202020201
1020202020202020202020202020202021
1202020202020202020202020202020201
1020202020202020202020202020202021
1202020202020202020202020202020201
1020202020202020202020202020202021
1202020202020202020202020202020201
1020202020202020202020202020202021
1202020202020202020202020202020201
1020202020202020202020202020202021
1202020202020202020202020202020201
1111111111111111111111111111111111


