MMMMMMMMMMMMMMMMMMMMMMMMMMMMMMMMMMMMMMMMMMMM
M00000P000000000000000000000000000000000000M
M000000000000000000000000000000000000000000M
M000000000000000000000000000000000000000000M
M000000000000000000000000000000000000000000M
MMMMMMMMMMMMMMMMMMMMMMMMMMMMMMMMMMMMMMMMMMMM
